1  |M1             |NGC 1952                 
2  |M2             |NGC 7089                 
3  |M3             |NGC 5272                 
4  |M4             |NGC 6121                 
5  |M5             |NGC 5904                 
6  |M6             |NGC 6405                 
7  |M7             |NGC 6475                 
8  |M8             |NGC 6523                      
9  |M9             |NGC 6333                 
10 |M10            |NGC 6254                 
11 |M11            |NGC 6705                 
12 |M12            |NGC 6218                 
13 |M13            |NGC 6205                 
14 |M14            |NGC 6402                 
15 |M15            |NGC 7078                 
16 |M16            |NGC 6611                 
17 |M17            |NGC 6618                 
18 |M18            |NGC 6613                 
19 |M19            |NGC 6273                 
20 |M20            |NGC 6514                 
21 |M21            |NGC 6531                 
22 |M22            |NGC 6656                 
23 |M23            |NGC 6494 
24 |M24            |IC 4715
24 |M24            |NGC 6603                 
25 |M25            |IC 4725                     
26 |M26            |NGC 6694                 
27 |M27            |NGC 6853                 
28 |M28            |NGC 6626                 
29 |M29            |NGC 6913                 
30 |M30            |NGC 7099                 
31 |M31            |NGC 224                  
32 |M32            |NGC 221                  
33 |M33            |NGC 598                  
34 |M34            |NGC 1039                 
35 |M35            |NGC 2168                 
36 |M36            |NGC 1960                 
37 |M37            |NGC 2099                 
38 |M38            |NGC 1912                 
39 |M39            |NGC 7092                         
41 |M41            |NGC 2287                 
42 |M42            |NGC 1976                 
43 |M43            |NGC 1982                 
44 |M44            |NGC 2632                                     
46 |M46            |NGC 2437                 
47 |M47            |NGC 2422                 
48 |M48            |NGC 2548                 
49 |M49            |NGC 4472                 
50 |M50            |NGC 2323                 
51 |M51            |NGC 5194                 
52 |M52            |NGC 7654                 
53 |M53            |NGC 5024                 
54 |M54            |NGC 6715                 
55 |M55            |NGC 6809                 
56 |M56            |NGC 6779                 
57 |M57            |NGC 6720                 
58 |M58            |NGC 4579                 
59 |M59            |NGC 4621                 
60 |M60            |NGC 4649                 
61 |M61            |NGC 4303                 
62 |M62            |NGC 6266                 
63 |M63            |NGC 5055                 
64 |M64            |NGC 4826                 
65 |M65            |NGC 3623                 
66 |M66            |NGC 3627                 
67 |M67            |NGC 2682                 
68 |M68            |NGC 4590                 
69 |M69            |NGC 6637                 
70 |M70            |NGC 6681                 
71 |M71            |NGC 6838                 
72 |M72            |NGC 6981                 
73 |M73            |NGC 6994                 
74 |M74            |NGC 628                  
75 |M75            |NGC 6864                 
76 |M76            |NGC 650                  
77 |M77            |NGC 1068                 
78 |M78            |NGC 2068                 
79 |M79            |NGC 1904                 
80 |M80            |NGC 6093                 
81 |M81            |NGC 3031                 
82 |M82            |NGC 3034                 
83 |M83            |NGC 5236                 
84 |M84            |NGC 4374                 
85 |M85            |NGC 4382                 
86 |M86            |NGC 4406                 
87 |M87            |NGC 4486                 
88 |M88            |NGC 4501                 
89 |M89            |NGC 4552                 
90 |M90            |NGC 4569                 
91 |M91            |NGC 4548                 
92 |M92            |NGC 6341                 
93 |M93            |NGC 2447                 
94 |M94            |NGC 4736                 
95 |M95            |NGC 3351                 
96 |M96            |NGC 3368                 
97 |M97            |NGC 3587                 
98 |M98            |NGC 4192                 
99 |M99            |NGC 4254                 
100|M100           |NGC 4321                 
101|M101           |NGC 5457                 
102|M102           |NGC 5866                 
103|M103           |NGC 581                  
104|M104           |NGC 4594                 
105|M105           |NGC 3379                 
106|M106           |NGC 4258                 
107|M107           |NGC 6171                 
108|M108           |NGC 3556                 
109|M109           |NGC 3992                 
110|M110           |NGC 205                  
